 9  8  7  6  5  4  3  2  3  4  5  6  7  8  9 10 
 8  7  6  5  4  3  2  1  2  3  4  5  6  7  8 -1 
 9  8  7 -1 -1  2  1  0  1 -1 -1  6  7  8  9 -1 
10  9  8 -1 -1  3  2  1  2 -1 -1  7  8  9 10 11 
 9  8  7  6  5  4  3  2  3  4  5  6  7  8  9 10 
-1 -1  8  7  6  5  4  3  4  5  6  7  8  9 10 11 
13 -1  9  8  7  6  5  4  5  6  7  8  9 10 11 12 
12 11 10  9  8  7  6  5  6  7  8  9 10 11 12 13 
13 12 11 -1 -1  8  7  6  7 -1 -1 10 11 12 13 -1 
14 13 12 -1 -1  9  8  7  8 -1 -1 11 12 13 -1 -1 
15 14 13 12 11 10  9  8  9 10 11 12 13 14 15 -1 
16 15 14 13 12 11 10  9 10 11 12 13 14 15 16 17 
17 16 15 14 13 12 11 10 11 12 13 14 15 16 17 18 
18 17 16 15 14 13 12 11 12 13 14 15 16 17 18 19 
19 -1 -1 16 15 16 13 12 13 14 15 16 17 18 19 20 
20 19 18 17 16 15 14 13 14 15 16 17 18 19 20 21 
